BBBBBBBBBBBBBBBBBBBBBBBBBBBBBBBBBBBBBBBBBBBBBBBBBBBWBBBBWBBBBBBBBB
B--------------------------------------------W------WWWW---WWWW--B
B--------------------------------------------W-W---W----W-W------B
B--------------------------------------------WW-W--W----W-W--WW--B
B--------------------------------------------WWWW---WWWW---WWWW--B
B----------------------------------------------------------------B
B----------------------------------------------------------------B
B----------------------------------------------------------------B
B----------------------------------------------------------------B
B------------------------------------------------------B---------B
B----------------------------------------------------------------B
B----------------------------------------------------------------B
B----------------------------------------------------------------B
B----------------------------------------------------------------B
B----------------------------------------------------------------B
B----------------------------------------------------------------B
B----------------------------------------------------------------B
B----------------------------------------------------------------B
B---------------------------P------------------------------------B
B----------------------------------------------------------------B
B----------------------------------------------------------------B
B--------------------------WWWW----------------------------------B
B-------------------------WBBBBW---------------------------------B
B------------------------WBBBBBBW--------------------------------B
WWWWWWWWWWWWWWWWWWWWWWWWWWWWWWWWWWWWWWWWWWWWWWWWWWWWWWWWWWWWWWWWWW
